xxxxxxxxxxxxxxxxxxx.
x..Dd.........nx..x.
x.................x.
xxxxxxxxxxxxxx...xx.n
x.........x..x..x...
x.x.xx....x..x.x..x.
x.x..x....x.xx.x..x.
x.x..xxx.......x..x.
x.x.....x..xxx.x..x.
x.xx.xx.....xxxx..x.
x..x...xxxxx......x.
x.............xx..x.
xxxxxxxxxxxxxxxxxxx.
