xxxxxxxxx
xn......x
x.......x
x...D...x
x...d...x
x.......x
x.......x
x.......x
xxxx.xxxx
xxxxxxxxx